1111111111111111111111111111111111111
1000100000000000100000000011111111111
11100011001001000000000000C1111111111
1E0000000010000C000000000000000000011
1110010000100000101011111111111111111
1010010110101010001000000000000000001
100000000CP0C000000000000000000000001
1111111111111111111111111111111111111