11111
1P1C1
1E111
10111
10111
11111