1111111
1E000P1
1000001
1C00X01
1111111