1111111111
100E000001
1PC0000001
1000000001
1111111111