1111111111111111111111111
1111111111111111111111111
1111111111111111111111111
1111111111111111111111111
1111111111110011111111111
1111111111110111111111111
1111111111111011111111111
1111111111111011111111111
111111111111P011111111111
1111111111111111111111111
1111111111111111111111111
1111111111111111111111111
1111111111111111111111111
1111111111111111111111111