1111111111
1CCCCCCCE1
1CCPCCCCC1
1CCCCCCCC1
1CCCCCCCC1
1111111111