1111111111
1P00000001
1011111101
1C0000C0E1
1111011111
1C00000001
1000000C01
1111111111
