11111111111111111111
1P0000000000000000E1
10111111101111111101
1C000000010000000001
10101111101011111101
1C0100000101000000C1
10101011101010111101
1C000100000101000001
10111011111010101101
10000000000000100001
11111110111110101111
1C000000C00000000001
10111111111111111001
1C00000000000000C001
11111111111111111111
