11111111
1P0000C1
11110101
1C0000E1
10000001
11111111
